NO ./assets/redbrick.png
SO ./assets/redbrick.png
WE ./assets/eagle.png
EA ./assets/wood.png

F 20,20,20
C 200,200,200

111111111111111111111111111111111
100000000000000000000000000000001
10000000000E000000011100000000001
10000000000000000001 100000000001
100000000000000000011100000000001
100000000000000000000000000000001
111111111111111111111111111111111