NO ./assets/redbrick.png
SO ./assets/colorstone.png
WE ./assets/bluestone.png
EA ./assets/wood.png

F 0,0,200
C 200,0,0

111111111111111111111111111111111
100000000000000000000000000000001
10000000000S000000011100000000001
10000000000000000001 100000000001
100000000000000000011100000000001
100000000000000000000000000000001
100000000000000000000000000000001
100000000000000000000000000000001
100000000000000000000000000000001
100000000000000000000000000000001
100000000000000000000000000000001
100000000000000000000000000000001
100000000000000000000000000000001
100000000000000000000000000000001
100000000000000000000000000000001
111111111111111111111111111111111