NO ./assets/redbrick.png
SO ./assets/colorstone.png
WE ./assets/bluestone.png
EA ./assets/wood.png

F 30,10,10 
C 0,100,200

11111111111111111111111111111111
1E000000000000100000000000000001
11101111111010110111111111101101
10000100001010000000100000100001
10011111101011111011101111101111
11010000100010000000100000101001
11010111111110111110001110101011
11010100000010100000101000100001
11010101111011101110101011101101
11010000100000100000100000100001
11010111101111101111101111101101
10000100101000000010000000101001
11011110101111111011101110101101
11000010001010001000101000101001
11011111111010111110101111101111
11010000000010000000100010000001
11010111111011101111111111101111
11000100000010001000000100000101
11110110111111101011101101111101
10000100000000100010000000100001
10110101111011101110101110111011
10000101000010000000101000100001
11110101111111111111101111101101
11000100001000000010000000101001
10010111101011111111111110101111
10110000101000001000000000100001
10111110101111101011111111101101
10000000100000001000000100001101
10111100000111101111110001111001
11111111111111111111111111111111
