NO ./assets/redbrick.png
SO ./assets/colorstone.png
WE ./assets/bluestone.png
EA ./assets/wood.png

F 55,55,0 
C 0,100,100

        1111111111111111111111111111
        1000000000000000000000001  1
        1001000000110000000000001  1
        1001000000110000000000001  1
111111111001000000110000000000001  1
100000000001000000110001111111111111
1000000000000000000000000000001
1110011111111100110001100110001
10000111100111001100011001100001111
1110011110011100110001100000001
1000000000000000110001111110001
1000000000000000000001111110001
1000000000000000N00000000000000111111111
1110011111100101111001111110000000000001
11100111 1100101 11001111110000000000001
11100001 1100101 11000000000000000000001
1111111111111111 11111111111111111111111